10 6
##########
###S######
####_#####
####_#####
#EAA___a##
#####B####
DR R L L L