10 10
##########
#S.#######
###.######
###.######
###..#####
##.#.#####
##a##A####
##.##.####
###..B..E#
##########
R DR DR DL DL DL UR UR R DR DR DR DR R R