10 10
##########
#S......##
###.####.#
###.####b#
###..###.#
##.#....##
##a##A####
##.##.####
###..B..E#
##########
R DR DR DL DL DL UR UR R DR DR DR DR R R