10 10
##########
#S.#######
###.######
###.######
####_#####
##..__..##
##.##_##.#
#.###...##
##..E#####
##########
R DR DR DR R R UR UL L L L DL DL DR R R