10 6
##########
###S######
####_#####
####_#####
#EA____a##
##########
DR R L L