40 30
########################################
###_________________________________####
#b____________________________________a#
#____________________________________#_#
##_____________________________________#
#_____________________________________##
#______________________________________#
#______________________________________#
#_____S________________________________#
#______________________________________#
#______________________________________#
#______________________________________#
#______________________________________#
#______________________________________#
#__________________AA__________________#
#_________________AcA__________________#
#__________________AA__________________#
#______________________________________#
#______________________________________#
#______________________________________#
#______________________________________#
#______________________________________#
#______________________________________#
#______________________________________#
##_____________________________________#
##____________________________________##
##C___________________________________D#
#d#__________________________________#B#
####_________________________________#E#
########################################
UL R L DR UR UL UL UR DR L DL DL UR R DR DL