  0  1  2  3  4  5  6  7  8  9  10 11 12 13 14 15 16 17 18 19
0 #  #  #  #  #  #  #  #  #  #  #  #  #  #  #  #  #  #  #  #
1 #  #  #  #  #  #  #  1  #  #  #  #  #  #  #  #  #  #  #  #
2 #  #  #  #  #  #  #  #  _  #  #  #  #  #  #  #  #  #  #  #
3 #  #  #  #  #  #  #  #  #  _  #  #  #  #  #  #  #  #  #  #
4 #  #  6  0  5  0  4  0  _  0  2  0  _  0  3  #  #  #  #  #
5 #  #  #  #  #  #  #  #  #  #  #  B  #  #  #  #  #  #  #  #
